O,+,0,0,0,0,0,0,0,0
0,+,+,0,0, , , , ,0
0, ,+,0, , ,0, , ,0
0, ,+,+,0, ,0, , ,0
0, ,0,+,0, , , , ,0
0, , ,+,+,+,0,0, ,0
0, , , ,0,+,0, , ,0
0, , , , ,+,0,0, ,0
0,0, ,0, ,+,+,+,+,0
0,0,0,0,0,0,0,0,+,O
